*************************
* **               *** **
*    ************* *** **
****  * * **       ***  *
*   *        * ***      *
* * * ****** * *** ***  *
* *          * * * * *  *
* ******* ** * * * * *  *
* * * **           * *  *
*        * * * * *   *  *
* * * ** * * * *******  *
* * * ** * *            *
* * *    * * * * * * *  *
* *   ** * * * * * * *  *
* * * ** * * *   *   *  *
* *   ** * * * *******  *
*   ****                *
* ********** * **********
*            *          *
*************************

