*************************
*          * *          *
* ******** * *** **  ** *
* *      * * * * **  ** *
* * **** * * * *     ** *
* * * ** *   * ******** *
*   * ** *** *          *
* *** **  *  * ******** *
* *** *** **     *** ****
*     * * **** *        *
* *** * * **** * ****** *
* * * * * **   * *   ** *
* * *   * *  * * * * ** *
* *   * *    * * * * ** *
* * *** ** * *   *      *
* *   * ** *** ******** *
*   * *           * *   *
* *** ** * ******** *** *
*        *              *
*************************

